.#.......$
####.##..$
.####~~~.$
..#~~#~~#$
.##~###~##
..##~#~~##
..#~~~~~#$
..##~~~~#$
.#~~~~~~#$
.##~~~~##$
$........$
$........$
$........$
$........$
.#.#####.#
..#..##.#.
$........$
$........$
$........$
$$$$$$$$$$
$$$$$$$$$$
$.........
$.........
$........$
#.........
##........
$##......$
$.##.....$
$.##.....$
$$.#$$$$$$
.#~~~~~#.$
.##~~~~~#.
.#~~~~~#..
.#~~~~~#..
..#~~~##..
..#~~##...
..##~#....
...##.....
..........
.........$
$$$$$$$$$$
.........$
.........$
.........$
.........$
.........#
.......###
........#.
.......##$
$.$$$$$$#$
$$#.$$$$$$
$.##......
$.##......
$.##......
$##.......
###.......
###.......
..........
$.........
$$..$$$$$$
.........$
..$.......
......$...
..........
$..$......
.....$....
.......$..
.$........
....$..$..
..........
$.$$$$$$#$
.......#.$
...#.###.$
...####..$
..######..
..#####...
...####..$
..#.##...$
.........$
.........$
$$..$$$$$$
$.........
$.........
$.........
..........
..........
$.........
$.........
$.........
$.........
